NO ./tests/maps/images/NO.xpm
SO ./tests/maps/images/SO.xpm
WE ./tests/maps/images/WE.xpm
EA ./tests/maps/images/EA.xpm

F 00,153,15
C 255,255,255

        1111111111111111111111111
        1000000000000000000000001
        1000000000000001111111111

        1000000000E00001
111111110z00000000000001
10000000000000000000000011111
11111111111111110000000000001
10000000000000010000000000001
10000111111111110000000000001
10000000000000000000000000001
10000000000000011111100000001
1001111111000001    100000011
10000011 1000001    100000001
11111111 1111111    111111111
