NO ./maps/assets/CONCRETE_2A.xpm
SO ./maps/assets/VENT_1A.xpm
WE ./maps/assets/TECH_1A.xpm
EA ./maps/assets/TECH_3G.xpm

F 20,22,25
C 13,14,15

111111111
101000001
101000001
10100000111111111111111111111111111111111111111111111111111111111111111111111111111111111111111111111111111111111111111111111111111111
1W000000000000000000000000000000000000000000000000000000000000000000000000000000000000000000000000000000000000000000000000000000000001
10000100111111111111111111111111111111111111111111111111111111111111111111111111111111111111111111111111111111111111111111111111111111
100000001
100000001
111111111
