NO ./maps/assets/wall_1.xpm
SO ./maps/assets/wall_2.xpm
WE ./maps/assets/wall_3.xpm
EA ./maps/assets/wall_4.xpm

F 00,153,15
C 255,255,255

111111111
101000001
101000S01
101000001
100000001
100001001
100000001
100000001
111111111
