NO ./maps/assets/CONCRETE_2A.xpm
SO ./maps/assets/VENT_1A.xpm
WE ./maps/assets/TECH_1A.xpm
EA ./maps/assets/TECH_3G.xpm

F 20,22,25
C 13,14,15

111111111
101000001
101000S01
101000001
100000001
100001001
100000001
100000001
111111111
