NO ./maps/assets/CONCRETE_2A.xpm
SO ./maps/assets/VENT_1A.xpm
WE ./maps/assets/TECH_1A.xpm
EA ./maps/assets/TECH_3G.xpm

F 20,22,25
C 13,14,15

111111111
101000001
10P000001
11100000111111111111111111111111111111111111111111111111111111111111111111111111111111111111111111111111111111111111111111111111111111
10000N00000000000000000000000000000000000000000000000000000000000000000000000000000000000000000000000000000000000000000000000000100001
1111P111111111111111111111111111111111111111111111111111111111111111111111111111111111111111111111111111111111111111111111111111111111
1001P1001
100000001
111111111
